/ Pacman Revolutions mapfile generated by Pacman level editor
3  1  1  1  1  1  1  1  1  1  1  1  1  8  8  1  1  1  1  1  1  1  1  1  1  1  1  4  
1  0  0  0  0  0  0  0  0  0  0  0  0  1  1  0  0  0  0  0  0  0  0  0  0  0  0  1  
1  0  3  1  1  4  0  3  1  1  1  4  0  1  1  0  3  1  1  1  4  0  3  1  1  4  0  1  
1  0  1  0  0  1  0  1  0  0  0  1  0  1  1  0  1  0  0  0  1  0  1  0  0  1  0  1  
1  0  6  1  1  5  0  6  1  1  1  5  0  6  5  0  6  1  1  1  5  0  6  1  1  5  0  1  
1  0  0  0  0  0  0  0  0  0  0  0  0  0  0  0  0  0  0  0  0  0  0  0  0  0  0  1  
1  0  3  1  1  4  0  3  4  0  3  1  1  1  1  1  1  4  0  3  4  0  3  1  1  4  0  1  
1  0  6  1  1  5  0  1  1  0  6  1  1  4  3  1  1  5  0  1  1  0  6  1  1  5  0  1  
1  0  0  0  0  0  0  1  1  0  0  0  0  1  1  0  0  0  0  1  1  0  0  0  0  0  0  1  
6  1  1  1  1  4  0  1  6  1  1  4  0  1  1  0  3  1  1  5  1  0  3  1  1  1  1  5  
0  0  0  0  0  1  0  1  3  1  1  5  0  6  5  0  6  1  1  4  1  0  1  0  0  0  0  0  
0  0  0  0  0  1  0  1  1  0  0  0  0  0  0  0  0  0  0  1  1  0  1  0  0  0  0  0  
0  0  0  0  0  1  0  1  1  0  3  1  1  2  2  1  1  4  0  1  1  0  1  0  0  0  0  0  
1  1  1  1  1  5  0  6  5  0  1  0  0  0  0  0  0  1  0  6  5  0  6  1  1  1  1  1  
0  0  0  0  0  0  0  0  0  0  1  0  0  0  0  0  0  1  0  0  0  0  0  0  0  0  0  0  
1  1  1  1  1  4  0  3  4  0  1  0  0  0  0  0  0  1  0  3  4  0  3  1  1  1  1  1  
0  0  0  0  0  1  0  1  1  0  6  1  1  1  1  1  1  5  0  1  1  0  1  0  0  0  0  0  
0  0  0  0  0  1  0  1  1  0  0  0  0  0  0  0  0  0  0  1  1  0  1  0  0  0  0  0  
0  0  0  0  0  1  0  1  1  0  3  1  1  1  1  1  1  4  0  1  1  0  1  0  0  0  0  0  
3  1  1  1  1  5  0  6  5  0  6  1  1  4  3  1  1  5  0  6  5  0  6  1  1  1  1  4  
1  0  0  0  0  0  0  0  0  0  0  0  0  1  1  0  0  0  0  0  0  0  0  0  0  0  0  1  
1  0  3  1  1  4  0  3  1  1  1  4  0  1  1  0  3  1  1  1  4  0  3  1  1  4  0  1  
1  0  6  1  4  1  0  6  1  1  1  5  0  6  5  0  6  1  1  1  5  0  1  3  1  5  0  1  
1  0  0  0  1  1  0  0  0  0  0  0  0  0  0  0  0  0  0  0  0  0  1  1  0  0  0  1  
6  1  4  0  1  1  0  3  4  0  3  1  1  1  1  1  1  4  0  3  4  0  1  1  0  3  1  8  
3  1  5  0  6  5  0  1  1  0  6  1  1  4  3  1  1  5  0  1  1  0  6  5  0  6  1  8  
1  0  0  0  0  0  0  1  1  0  0  0  0  1  1  0  0  0  0  1  1  0  0  0  0  0  0  1  
1  0  3  1  1  1  1  5  6  1  1  4  0  1  1  0  3  1  1  5  6  1  1  1  1  4  0  1  
1  0  6  1  1  1  1  1  1  1  1  5  0  6  5  0  6  1  1  1  1  1  1  1  1  5  0  1  
1  0  0  0  0  0  0  0  0  0  0  0  0  0  0  0  0  0  0  0  0  0  0  0  0  0  0  1  
6  1  1  1  1  1  1  1  1  1  1  1  1  1  1  1  1  1  1  1  1  1  1  1  1  1  1  5  
